50;-;-;-;-;-;-;-;-;-;-;-;-;-;-;-;-;-;-;-
500;-;-;-;-;-;-;-;-;-;F;-;-;-;-;-;-;-;-;-
50;-;-;-;-;-;-;-;-;F;-;F;-;-;-;-;-;-;-;-
50;-;-;-;-;-;-;-;F;-;-;-;F;-;-;-;-;-;-;-
50;-;-;-;-;-;-;F;-;-;-;-;-;F;-;-;-;-;-;-

400;-;-;-;F;-;-;-;-;-;-;-;-;-;-;-;F;-;-;-
50;-;-;F;B;F;-;-;-;-;-;-;-;-;-;F;B;F;-;-
50;-;-;-;F;-;-;-;-;-;-;-;-;-;-;-;F;-;-;-

1000;-;-;-;-;-;-;-;-;-;F;-;-;-;-;-;-;-;-;-
50;-;-;-;-;-;-;-;-;F;-;F;-;-;-;-;-;-;-;-
50;-;-;-;-;-;-;-;F;-;F;-;F;-;-;-;-;-;-;-
50;-;-;-;-;-;-;F;-;-;-;-;-;F;-;-;-;-;-;-
50;-;-;-;-;-;F;-;-;-;-;-;-;-;F;-;-;-;-;-
50;-;-;-;-;F;-;-;-;-;-;-;-;-;-;F;-;-;-;-
50;-;-;-;F;-;-;-;-;-;B;-;-;-;-;-;F;-;-;-
50;-;-;F;-;-;-;-;-;-;-;-;-;-;-;-;-;F;-;-
50;-;F;-;-;-;-;-;-;-;-;-;-;-;-;-;-;-;F;-
50;F;-;-;-;-;-;-;-;-;-;-;-;-;-;-;-;-;-;F

300;-;-;-;F;F;F;-;-;-;-;-;-;-;-;-;-;-;-;-
50;-;-;F;F;F;-;-;-;-;-;-;-;-;-;-;-;-;-;-
50;-;-;-;F;F;F;-;-;-;-;-;-;-;-;-;-;-;-;-
50;-;-;-;-;-;-;-;-;-;-;-;-;-;F;F;F;-;-;-
50;-;-;-;-;-;-;-;-;-;-;-;-;-;-;F;F;F;-;-
50;-;-;-;-;-;-;-;-;-;-;-;-;-;F;F;F;-;-;-

300;-;-;-;-;-;-;-;-;-;F;-;-;-;-;-;-;-;-;-
50;-;-;-;-;-;-;-;-;-;F;-;-;-;-;-;-;-;-;-
50;-;-;-;-;-;-;-;-;-;F;-;-;-;-;-;-;-;-;-
50;-;-;-;-;-;-;-;-;-;F;-;-;-;-;-;-;-;-;-
50;-;-;-;-;-;-;-;-;-;F;-;-;-;-;-;-;-;-;-
50;-;-;-;-;-;F;-;-;-;F;-;-;-;F;-;-;-;-;-
50;-;-;-;-;-;F;-;-;-;F;-;-;-;F;-;-;-;-;-
50;-;-;-;-;-;F;-;-;-;-;-;-;-;F;-;-;-;-;-
50;-;-;-;-;-;F;-;-;-;-;-;-;-;F;-;-;-;-;-
50;-;-;-;-;-;F;-;-;F;F;F;-;-;F;-;-;-;-;-
50;-;-;-;-;-;B;-;-;B;B;B;-;-;B;-;-;-;-;-

400;-;-;-;-;-;-;-;-;-;F;-;-;-;-;-;-;-;-;-
50;-;-;-;-;-;-;-;-;F;-;F;-;-;-;-;-;-;-;-
50;-;-;F;-;-;-;-;F;-;F;-;F;-;-;-;-;F;-;-
50;-;F;-;F;-;-;F;-;F;-;F;-;F;-;-;F;-;F;-

300;-;-;F;-;-;-;-;-;-;-;-;-;-;-;-;-;-;-;-
50;-;-;-;F;-;-;-;-;-;-;-;-;-;-;-;-;-;-;-
50;-;-;-;-;F;-;-;-;-;-;-;F;F;F;-;-;-;-;-
50;-;-;-;-;-;F;-;-;-;-;-;F;F;F;-;-;-;-;-
50;-;-;-;-;-;-;F;-;-;-;-;-;-;-;-;-;-;-;-
50;-;-;-;-;-;-;-;F;-;-;-;-;-;-;-;-;F;-;-
50;-;-;-;-;-;-;-;-;F;-;-;-;-;-;-;F;-;-;-
50;-;-;-;-;-;-;-;-;-;F;-;-;-;-;F;-;-;-;-
50;-;-;-;-;-;-;-;-;-;-;F;-;-;F;-;-;-;-;-
50;-;-;B;B;B;-;-;-;-;-;-;-;F;-;-;-;-;-;-
50;-;-;-;B;-;-;-;-;-;-;-;F;-;-;-;-;-;-;-
50;-;-;-;-;-;-;-;-;-;-;F;-;-;-;-;-;-;-;-
50;-;-;-;-;-;-;-;-;-;F;-;-;-;-;-;-;-;-;-
50;-;-;-;-;-;-;-;-;F;-;-;-;-;-;-;-;-;-;-

50;-;-;-;-;-;-;-;-;-;-;-;-;-;-;-;-;-;-;-
500;-;-;-;-;-;-;-;-;-;F;-;-;-;-;-;-;-;-;-
50;-;-;-;-;-;-;-;-;F;-;F;-;-;-;-;-;-;-;-
50;-;-;-;-;-;-;-;F;-;-;-;F;-;-;-;-;-;-;-
50;-;-;-;-;-;-;F;-;-;-;-;-;F;-;-;-;-;-;-

400;-;-;-;F;-;-;-;-;-;-;-;-;-;-;-;F;-;-;-
50;-;-;F;F;F;-;-;-;-;-;-;-;-;-;F;F;F;-;-
50;-;-;-;F;-;-;-;-;-;-;-;-;-;-;-;F;-;-;-

1000;-;-;-;-;-;-;-;-;-;F;-;-;-;-;-;-;-;-;-
50;-;-;-;-;-;-;-;-;F;-;F;-;-;-;-;-;-;-;-
50;-;-;-;-;-;-;-;F;-;F;-;F;-;-;-;-;-;-;-
50;-;-;-;-;-;-;F;-;-;-;-;-;F;-;-;-;-;-;-
50;-;-;-;-;-;F;-;-;-;-;-;-;-;F;-;-;-;-;-
50;-;-;-;-;F;-;-;-;-;-;-;-;-;-;F;-;-;-;-
50;-;-;-;F;-;-;-;-;-;-;-;-;-;-;-;F;-;-;-
50;-;-;F;-;-;-;-;-;-;-;-;-;-;-;-;-;F;-;-
50;-;F;-;-;-;-;-;-;-;-;-;-;-;-;-;-;-;F;-
50;F;-;-;-;-;-;-;-;-;-;-;-;-;-;-;-;-;-;F

400;-;-;-;-;-;-;-;-;-;F;-;-;-;-;-;-;-;-;-
50;-;-;-;-;-;-;-;-;F;-;F;-;-;-;-;-;-;-;-
50;-;-;F;-;-;-;-;F;-;F;-;F;-;-;-;-;F;-;-
50;-;F;-;F;-;-;F;-;F;-;F;-;F;-;-;F;-;F;-

300;-;-;F;-;-;-;-;-;-;-;-;-;-;-;-;-;-;-;-
50;-;-;-;F;-;-;-;-;-;-;-;-;-;-;-;-;-;-;-
50;-;-;-;-;F;-;-;-;-;-;-;F;F;F;-;-;-;-;-
50;-;-;-;-;-;F;-;-;-;-;-;F;F;F;-;-;-;-;-
50;-;-;-;-;-;-;F;-;-;-;-;-;-;-;-;-;-;-;-
50;-;-;-;-;-;-;-;F;-;-;-;-;-;-;-;-;F;-;-
50;-;-;-;-;-;-;-;-;F;-;-;-;-;-;-;F;-;-;-
50;-;-;-;-;-;-;-;-;-;F;-;-;-;-;F;-;-;-;-
50;-;-;-;-;-;-;-;-;-;-;F;-;-;F;-;-;-;-;-
50;-;-;-;-;-;-;-;-;-;-;-;-;F;-;-;-;-;-;-
50;-;-;-;-;-;-;-;-;-;-;-;F;-;-;-;-;-;-;-
50;-;-;-;-;-;-;-;-;-;-;F;-;-;-;-;-;-;-;-
50;-;-;-;-;-;-;-;-;-;F;-;-;-;-;-;-;-;-;-
50;-;-;-;-;-;-;-;-;F;-;-;-;-;-;-;-;-;-;-

300;-;-;-;-;-;-;-;-;-;-;-;-;-;F;F;F;F;-;-
50;-;-;-;-;-;-;-;-;-;-;-;-;-;F;F;F;F;-;-
50;-;-;-;-;-;-;-;-;-;-;-;-;-;F;F;F;F;-;-
50;-;-;F;F;F;F;-;-;-;-;-;-;-;-;-;-;-;-;-
50;-;-;F;F;F;F;-;-;-;-;-;-;-;-;-;-;-;-;-
50;-;-;F;F;F;F;-;-;-;-;-;-;-;-;-;-;-;-;-

200;-;-;-;-;-;-;-;-;-;-;-;-;-;F;F;F;F;-;-
50;-;-;-;-;-;-;-;-;-;-;-;-;-;F;F;F;F;-;-
50;-;-;F;F;F;F;-;-;-;-;-;-;-;-;-;-;-;-;-
50;-;-;F;F;F;F;-;-;-;-;-;-;-;-;-;-;-;-;-

200;-;-;-;-;-;-;-;-;-;-;-;-;-;F;F;F;F;-;-
50;-;-;F;F;F;F;-;-;-;-;-;-;-;-;-;-;-;-;-

1000;-;-;-;-;-;-;-;-;-;F;-;-;-;-;-;-;-;-;-
50;-;-;-;-;-;-;-;-;F;-;F;-;-;-;-;-;-;-;-
50;-;-;-;-;-;-;-;F;-;F;-;F;-;-;-;-;-;-;-
50;-;-;-;-;-;-;F;-;-;-;-;-;F;-;-;-;-;-;-
50;-;-;-;-;-;F;-;-;-;-;-;-;-;F;-;-;-;-;-
50;-;-;-;-;F;-;-;-;-;-;-;-;-;-;F;-;-;-;-
50;-;-;-;F;-;-;-;-;-;F;-;-;-;-;-;F;-;-;-
50;-;-;F;-;-;-;-;-;F;-;F;-;-;-;-;-;F;-;-
50;-;F;-;-;-;-;-;F;-;-;-;F;-;-;-;-;-;F;-
50;F;-;-;-;-;-;-;-;-;-;-;-;-;-;-;-;-;-;F

1000;-;-;-;-;F;-;-;-;-;-;-;-;-;-;-;-;-;-;-
50;-;-;-;-;F;-;-;-;-;-;-;-;-;-;-;-;-;-;-
50;-;-;-;-;F;-;-;-;-;-;-;-;-;-;-;-;-;-;-
50;-;-;-;-;F;-;-;-;-;-;-;-;-;-;-;-;-;-;-
50;-;-;-;-;F;-;-;-;-;-;-;-;-;-;-;-;-;-;-
50;-;-;-;-;F;-;-;-;-;-;-;-;-;-;-;-;-;-;-
50;-;-;-;-;F;-;-;-;-;-;-;-;-;-;-;-;-;-;-
50;-;-;-;-;F;-;-;-;-;-;-;-;-;-;-;-;-;-;-
50;-;-;-;-;F;-;-;-;-;-;-;-;-;-;-;-;-;-;-
50;-;-;-;-;F;-;-;-;-;-;-;-;-;-;-;-;-;-;-
50;-;-;-;-;F;-;-;-;-;-;-;-;-;-;-;-;-;-;-
50;-;-;-;-;F;-;-;-;-;-;-;-;-;-;-;-;-;-;-
50;-;-;-;-;F;-;-;-;-;-;-;-;-;-;F;-;-;-;-
50;-;-;-;-;F;-;-;-;-;-;-;-;-;-;F;-;-;-;-
50;-;-;-;-;-;-;-;-;-;-;-;-;-;-;F;-;-;-;-
50;-;-;-;-;-;-;-;-;-;-;-;-;-;-;F;-;-;-;-
50;-;-;-;-;-;-;-;-;-;-;-;-;-;-;F;-;-;-;-
50;-;-;-;-;-;-;-;-;-;-;-;-;-;-;F;-;-;-;-
50;-;-;-;-;-;-;-;-;-;-;-;-;-;-;F;-;-;-;-
50;-;-;-;-;-;-;-;-;-;-;-;-;-;-;F;-;-;-;-
50;-;-;-;-;-;-;-;-;-;-;-;-;-;-;F;-;-;-;-
50;-;-;-;-;-;-;-;-;-;-;-;-;-;-;F;-;-;-;-
50;-;-;-;-;-;-;-;-;-;-;-;-;-;-;F;-;-;-;-
50;-;-;-;-;-;-;-;-;-;-;-;-;-;-;F;-;-;-;-
50;-;-;-;-;-;-;-;-;-;F;-;-;-;-;F;-;-;-;-
50;-;-;-;-;-;-;-;-;-;F;-;-;-;-;F;-;-;-;-
50;-;-;-;-;-;-;-;-;-;F;-;-;-;-;-;-;-;-;-
50;-;-;-;-;-;-;-;-;-;F;-;-;-;-;-;-;-;-;-
50;-;-;-;-;-;-;-;-;-;F;-;-;-;-;-;-;-;-;-
50;-;-;-;-;-;-;-;-;-;F;-;-;-;-;-;-;-;-;-
50;-;-;-;-;-;-;-;-;-;F;-;-;-;-;-;-;-;-;-
50;-;-;-;-;-;-;-;-;-;F;-;-;-;-;-;-;-;-;-
50;-;-;-;-;-;-;-;-;-;F;-;-;-;-;-;-;-;-;-
50;-;-;-;-;-;-;-;-;-;F;-;-;-;-;-;-;-;-;-
50;-;-;-;-;-;-;-;-;-;F;-;-;-;-;-;-;-;-;-
50;-;-;-;-;-;-;-;-;-;F;-;-;-;-;-;-;-;-;-
50;-;-;-;-;-;-;-;-;-;F;-;-;-;-;-;-;-;-;-
50;-;-;-;-;-;-;-;-;-;F;-;-;-;-;-;-;-;-;-

200;-;-;F;F;-;-;-;-;-;-;-;-;-;-;-;-;-;-;-
50;-;-;-;-;-;-;-;-;-;-;-;-;-;-;-;F;F;-;-
50;-;-;-;-;F;F;-;-;-;-;-;-;-;-;-;-;-;-;-
50;-;-;-;-;-;-;-;-;-;-;-;-;-;F;F;-;-;-;-
50;-;-;-;-;-;-;F;F;-;-;-;-;-;-;-;-;-;-;-
50;-;-;-;-;-;-;-;-;-;-;-;F;F;-;-;-;-;-;-

200;-;-;-;-;-;-;F;-;-;-;-;-;F;-;-;-;-;-;-
50;-;-;-;-;-;-;-;F;-;-;-;F;-;-;-;-;-;-;-
50;-;-;-;-;-;-;-;-;F;-;F;-;-;-;-;-;-;-;-
50;-;-;-;-;-;-;-;-;-;F;-;-;-;-;-;-;-;-;-

90;-;-;-;F;-;-;-;-;-;-;-;-;-;-;-;F;-;-;-
50;-;-;F;-;F;-;-;-;-;-;-;-;-;-;F;-;F;-;-

150;-;-;-;-;-;-;-;-;-;F;-;-;-;-;-;-;-;-;-
50;-;-;-;-;-;-;-;-;F;F;F;-;-;-;-;-;-;-;-
50;-;-;-;B;-;-;-;F;F;F;F;F;-;-;-;B;-;-;-
50;-;-;-;B;-;-;-;-;F;F;F;-;-;-;-;B;-;-;-
50;-;-;-;-;-;-;-;-;-;F;-;-;-;-;-;-;-;-;-

50;-;-;-;-;-;-;-;-;-;-;-;-;-;-;-;-;-;-;-


