50;-;-;-;-;-;-;-;-;-;-;-;-;-;-;-;-;-;-;-
500;-;-;-;-;-;-;-;-;-;-;-;-;-;-;-;-;-;-;-

50;-;-;-;-;-;-;-;F;F;F;F;F;-;-;-;-;-;-;-
50;-;-;-;-;-;-;-;F;-;-;-;-;-;-;-;-;-;-;-
50;-;-;-;-;-;-;-;F;-;-;-;-;-;-;-;-;-;-;-
50;-;-;-;-;-;-;-;F;F;F;F;F;-;-;-;-;-;-;-
50;-;-;-;-;-;-;-;-;-;-;-;F;-;-;-;-;-;-;-
50;-;-;-;-;-;-;-;-;-;-;-;F;-;-;-;-;-;-;-
50;-;-;-;-;-;-;-;F;F;F;F;F;-;-;-;-;-;-;-